border_size=1
usage=map

Xuce        , Xuce        , Xuce        , Xuce        , Xuce        , Xuce        , Xuce        , Xuce        , Xuce        , Xuce        , Xuce        , Xuce        , Xuce        , Xuce        , Xuce        , Xuce        , Xuce        , Xuce        , Xuce        , Xuce        , Xuce        , Qxua        , Qxua        , Qxua        , Qxua        , Qxua        , Qxua        , Qxua        , Qxua        , Qxua        , Qxua        , Qxua        , Zw          , Zw          , Zw          , Urb         , Urb         , Urb         , Zw          , Zw          
Xuce        , Xuce        , Xuce        , Xuce        , Xuce        , Xuce        , Xuce        , Xuce        , Xuce        , Xuce        , Xuce        , Xuce        , Xuce        , Xuce        , Xuce        , Xuce        , Xuce        , Xuce        , Xuce        , Xuce        , Xuce        , Qxua        , Qxua        , Qxua        , Qxua        , Qxua        , Qxua        , Qxua        , Qxua        , Qxua        , Qxua        , Qxua        , Qxua        , Zw          , Zw          , Urb         , Urb         , 3 Urb       , 2 Zw        , Zw          
Xuce        , Xuce        , Xuce        , Xuce        , Xuce        , Xuce        , Xuce        , Xuce        , Xuce        , Xuce        , Xuce        , Xuce        , Xuce        , Xuce        , Xuce        , Xuce        , Xuce        , Xuce        , Xuce        , Xuce        , Xuce        , Qxua        , Qxua        , Qxua        , Qxua        , Qxua        , Qxua        , Qxua        , Qxua        , Qxua        , Qxua        , Qxua        , Zw          , Zw          , Md          , Mv          , Md          , 4 Zw        , Urb         , Urb         
Xuce        , Xuce        , Xuce        , Xuce        , Xuce        , Xuce        , Xuce        , Xuce        , Xuce        , Xuce        , Xuce        , Xuce        , Xuce        , Xuce        , Xuce        , Xuce        , Qxua        , Qxua        , Qxua        , Qxua        , Qxua        , Qxua        , Qxua        , Qxua        , Qxua        , Qxua        , Qxua        , Qxua        , Qxua        , Qxua        , Qxua        , Qxua        , Zw          , Zw          , Zw          , Md          , Urb         , Urb         , Uue         , Uue         
Xuce        , Xuce        , Xuce        , Xuce        , Xuce        , Xuce        , Qxua        , Xuce        , Qxua        , Xuce        , Qxua        , Xuce        , Qxua        , Xuce        , Qxua        , Qxua        , Qxua        , Qxua        , Qxua        , Qxua        , Qxua        , Qxua        , Qxua        , Qxua        , Qxua        , Qxua        , Qxua        , Qxua        , Qxua        , Qxua        , Qxua        , Qxua        , Zw          , Zw          , Uu          , Urb         , Uu          , Zw          , Uue         , Uue         
Xuce        , Xuce        , Xuce        , Xuce        , Qxua        , Qxua        , Qxua        , Qxua        , Qxua        , Qxua        , Qxua        , Qxua        , Qxua        , Qxua        , Qxua        , Qxua        , Qxua        , Qxua        , Qxua        , Qxua        , Qxua        , Qxua        , Aa          , Qxua        , Aa          , Qxua        , Qxua        , Qxua        , Qxua        , Qxua        , Qxua        , Qxua        , Zw^Qc1      , Uu          , Uu          , Uu          , Urb         , Urb         , Zw          , Urb         
Xuce        , Xuce        , Xuce        , Qxua        , Qxua        , Qxua        , Qxua        , Qxua        , Qxua        , Qxua        , Qxua        , Qxua        , Qxua        , Qxua        , Qxua        , Qxua        , Aa          , Aa          , Ms          , Ms          , Ms          , Ms          , Aa          , Aa          , Aa          , Qxua        , Qxua        , Qxua        , Qxua        , Qxua        , Qxua        , Qxua        , Zw          , Zw^Qc1      , Urb^Qc1     , Urb         , Urb         , Urb         , Uu          , Uu          
Xuce        , Xuce        , Xuce        , Qxua        , Qxua        , Qxua        , Qxua        , Aa          , Aa          , Qxua        , Aa          , Qxua        , Qxua        , Qxua        , Aa          , Aa          , Aa          , Aa          , Ai          , Ms          , Ms          , Zw          , Zw          , Zw          , Aa          , Aa          , Qxua        , Qxua        , Qxua        , Qxua        , Urb         , Urb         , Ql          , Ql          , Ur          , Zw          , Ur^Qc1      , Ur          , Uu          , Uu          
Xuce        , Xuce        , Xuce        , Qxua        , Qxua        , Qxua        , Aa          , Aa          , Aa          , Aa          , Aa          , Aa          , Aa          , Aa          , Aa          , Aa          , Ai          , Ai          , Ai          , Ai          , Ms^Xm       , Zw          , Zw          , Zw          , Aa          , Aa          , Aa          , Qxua        , Qxua        , Qxua        , Urb         , Urb         , Ql          , Ql          , Zw          , Ur          , Uue         , Ur^Qc1      , Ur^Qc1      , Ur          
Xuce        , Xuce        , Xuce        , Qxua        , Qxua        , Qxua        , Aa          , Ms          , Ms          , Aa          , Ms          , Aa          , Aa          , Zw          , Zw          , Ai          , Ai          , Ai          , Ai          , Ai          , Aa          , Aa          , Aa^Qc1      , Aa          , Aa          , Aa          , Aa          , Aa          , Aa          , Qxua        , Uu^Cd       , Urb         , Urb         , Zw          , Zw          , Uue         , Ur          , Ur          , Ur          , Ur^Qc1      
Xuce        , Xuce        , Xuce        , Qxua        , Qxua        , Qxua        , Aa          , Aa          , Ms          , Ms          , Ms          , Ms          , Ms          , Zw          , Aa          , Aa          , Aa          , Aa          , Aa          , Aa          , Zw          , Ur          , Aa          , Aa          , Aa          , Aa          , Aa^Dr       , Aa          , Aa          , Aa          , Ur          , Ur          , Uu^Cd       , Zw          , Qxua        , Urb         , Urb         , Ur          , Ur          , Ur          
Xuce        , Xuce        , Xuce        , Qxua        , Qxua        , Qxua        , Aa          , Aa          , Ms          , Ms          , Ms          , Ms          , Ms          , Ms          , Qxua        , Aa          , Qxua        , Aa          , Qxua        , Zw          , Ur          , Ur          , Aa          , Aa          , Ha          , Aa          , Aa          , Aa          , Aa          , Aa          , Aa          , Aa          , Qxua        , Qxua        , Qxua        , Qxua        , Qxua        , Qxua        , Qxua        , Ur          
Xuce        , Xuce        , Xuce        , Qxua        , Qxua        , Qxua        , Qxua        , Aa          , Aa          , Ms          , Ms          , Ms          , Ms          , Qxua        , Qxua        , Qxua        , Qxua        , Qxua        , Qxua        , Zw          , Aa          , Aa          , Chr         , Aa          , Ha          , Ha          , Ha          , Aa          , Aa          , Aa          , Aa          , Aa          , Aa          , Qxua        , Qxua        , Qxua        , Qxua        , Qxua        , Qxua        , Qxua        
Xuce        , Xuce        , Xuce        , Qxua        , Qxua        , Qxua        , Qxua        , Aa          , Aa          , Ms          , Qxua        , Ms          , Aa^Dr       , Aa          , Aa          , Qxua        , Qxua        , Qxua        , Qxua        , Aa          , Chr         , Chr^Dr      , Chr^Dr      , Aa          , Aa          , Ha          , Aa          , Aa          , Aa          , Aa          , Aa          , Aa          , Aa          , Aa          , Aa          , Qxua        , Qxua        , Qxua        , Qxua        , Qxua        
Xuce        , Xuce        , Xuce        , Qxua        , Qxua        , Qxua        , Qxua        , Qxua        , Qxua        , Qxua        , Qxua        , Qxua        , Qxua        , Aa          , Chr         , Aa          , Qxua        , Qxua        , Qxua        , Aa          , Aa          , Cha^Dr      , Aa          , Aa          , Aa^Dr       , Aa          , Aa          , Aa          , Aa          , Aa          , Aa          , Aa          , Aa          , Aa          , Aa          , Qxua        , Qxua        , Qxua        , Qxua        , Qxua        
Xuce        , Xuce        , Xuce        , Qxua        , Qxua        , Qxua        , Qxua        , Qxua        , Aa          , Qxua        , Aa          , Qxua        , Chr^Dr      , Chr^Dr      , Aa          , Aa          , Qxua        , Qxua        , Aa          , Aa          , Aa          , Aa          , Aa          , Aa          , Aa          , Aa          , Aa          , Qxua        , Qxua        , Aa          , Qxua        , Qxua        , Qxua        , Qxua        , Qxua        , Qxu^Bsz\    , Qxua        , Qxua        , Qxua        , Qxua        
Xuce        , Xuce        , Xuce        , Xuce        , Qxua        , Qxua        , Qxua        , Qxua        , Aa          , Aa          , Aa          , Chr^Dr      , Chr^Dr      , Chr^Dr      , Aa          , Aa          , Aa          , Aa          , Aa          , Aa          , Aa^Dr       , Aa          , Aa          , Aa          , Uu          , Aa          , Aa          , Qxua        , Aa          , Qxua        , Qxua        , Qxua        , Qxua        , Qxua        , Qxua        , Qxua        , Qxua        , Qxu^Bsz\    , Aa^Dr       , Aa          
Xuce        , Xuce        , Qxua        , Qxua        , Qxua        , Qxua        , Qxua        , Aa          , Uu^Dr       , Uu          , Urb         , Aa          , Aa          , Aa          , Aa          , Aa          , Aa^Dr       , Aa^Dr       , Aa          , Aa          , Aa          , Aa          , Aa          , Uu          , Urb         , Urb         , Urb         , Aa          , Ur          , Ur          , Ur          , Qxua        , Qxua        , Qxua        , Qxua        , Qxua        , Qxua        , Aa^Dr       , Aa          , Aa          
Xuce        , Xuce        , Xuce        , Qxua        , Qxua        , Qxua        , Qxua        , Aa          , Uu          , Uu          , Uh          , Urb         , Ur          , Aa          , Aa          , Aa          , Urb         , Aa^Br|      , Urb         , Aa^Dr       , Xuce        , Aa          , Xuce        , Uu          , Xuce        , Urb         , Xuce        , Xuce        , Xuce        , Ur          , Xuce        , Qxua        , Qxua        , Qxua        , Qxua        , Qxua        , Qxua        , Qxua        , Qxua        , Qxua        
Xuce        , Xuce        , Xuce        , Qxua        , Qxua        , Qxua        , Qxua        , Qxua        , Urb         , Uh          , Uh          , Ur          , Ur          , Aa          , Aa          , Aa          , Uu^Cd       , Urb^Br|     , Urb         , Xuce        , Qxua        , Xuce        , Qxua        , Xuce        , Xuce        , Xuce        , Xuce        , Xuce        , Xuce        , Xuce        , Qxua        , Qxua        , Qxua        , Qxua        , Qxua        , Qxua        , Qxua        , Qxua        , Qxua        , Qxua        
Xuce        , Xuce        , Xuce        , Xuce        , Xuce        , Qxua        , Xuce        , Xuce        , Xuce        , Urb         , Xuce        , Xuce        , Xuce        , Aa          , Aa          , Aa          , Zw          , Aa^Br|      , Urb         , Urb         , Ms          , Qxua        , Ms          , Xuce        , Xuce        , Xuce        , Xuce        , Xuce        , Xuce        , Qxua        , Qxua        , Qxua        , Qxua        , Qxua        , Qxua        , Qxua        , Qxua        , Qxua        , Qxua        , Qxua        
Xuce        , Xuce        , Xuce        , Xuce        , Xuce        , Xuce        , Xuce        , Xuce        , Xuce        , Xuce        , Xuce        , Xuce        , Xuce        , Uue         , Uue         , Uue         , Zw          , Aa^Br|      , Urb         , Ms          , Ms          , Ms          , Ms          , Ms          , Ms          , Xuce        , Xuce        , Xuce        , Qxua        , Qxua        , Qxua        , Qxua        , Qxua        , Qxua        , Qxua        , Qxua        , Qxua        , Qxua        , Qxua        , Qxua        
Xuce        , Xuce        , Xuce        , Xuce        , Xuce        , Xuce        , Xuce        , Xuce        , Xuce        , Xuce        , Xuce        , Xuce        , Xuce        , Zw          , Zw          , Uue         , Uu          , Aa^Br|      , Aa^Br\      , Ms          , Mm          , Mv          , Mm          , Ms          , Xuce        , Xuce        , Qxua        , Qxua        , Qxua        , Qxua        , Qxua        , Qxua        , Qxua        , Qxua        , Qxua        , Qxua        , Qxua        , Qxua        , Qxua        , Qxua        
Xuce        , Xuce        , Xuce        , Xuce        , Xuce        , Xuce        , Xuce        , Xuce        , Xuce        , Xuce        , Xuce        , Xuce        , Qxua        , Qxua        , Qxua        , Qxua        , Uu          , Uu          , Uu          , Aa^Br\      , Aa^Br\      , Mm          , Aa^Br/      , Aa^Br/      , Qxua        , Xuce        , Qxua        , Qxua        , Qxua        , Qxua        , Qxua        , Qxua        , Qxua        , Qxua        , Qxua        , Qxua        , Qxua        , Qxua        , Qxua        , Qxua        
Xuce        , Xuce        , Xuce        , Xuce        , Xuce        , Xuce        , Xuce        , Xuce        , Xuce        , Xuce        , Xuce        , Xuce        , Qxua        , Qxua        , Qxua        , Ur          , Ur          , Uu          , Urb         , Urb         , Aa          , Aa^Br\      , Aa          , Aa          , Qxua        , Qxua        , Qxua        , Qxua        , Qxua        , Qxua        , Qxua        , Qxua        , Qxua        , Qxua        , Qxua        , Qxua        , Qxua        , Qxua        , Qxua        , Qxua        
Xuce        , Xuce        , Xuce        , Xuce        , Xuce        , Xuce        , Xuce        , Xuce        , Xuce        , Xuce        , Xuce        , Xuce        , Aa          , Aa          , Aa          , Ur          , Ur          , Ur          , Ur          , Urb         , Aa^Br/      , Aa^Br|      , Ai          , Aa          , Aa          , Qxua        , Qxua        , Qxua        , Qxua        , Qxua        , Qxua        , Qxua        , Qxua        , Qxua        , Qxua        , Qxua        , Qxua        , Qxua        , Qxua        , Qxua        
Xuce        , Xuce        , Xuce        , Xuce        , Xuce        , Xuce        , Xuce        , Xuce        , Xuce        , Xuce        , Xuce        , Xuce        , Aa          , Aa          , Aa          , Urb         , Urb         , Urb         , Aa^Br|      , Aa^Br/      , Cea         , Ai          , Ai          , Ai          , Ai          , Aa          , Aa          , Qxua        , Aa          , Qxua        , Aa          , Qxua        , Qxua        , Qxua        , Qxua        , Qxua        , Qxua        , Qxua        , Qxua        , Qxua        
Xuce        , Xuce        , Xuce        , Xuce        , Xuce        , Xuce        , Xuce        , Xuce        , Xuce        , Xuce        , Xuce        , Xuce        , Xuce        , Xuce        , Xuce        , Urb         , Urb         , Urb         , Aa^Br|      , Cea         , Cea         , Ai          , Uu          , Ai          , Aa          , Aa          , Ms          , Ms          , Ms          , Aa          , Ms          , Aa          , Aa          , Qxua        , Qxua        , Qxua        , Qxua        , Qxua        , Qxua        , Qxua        
Xuce        , Xuce        , Xuce        , Xuce        , Xuce        , Xuce        , Xuce        , Xuce        , Xuce        , Xuce        , Xuce        , Xuce        , Xuce        , Xuce        , Xuce        , Xuce        , Xuce        , Aa          , Aa^Br|      , Cea         , Aa          , Uu          , Uu          , Uu          , Aa          , Ms          , Ms          , Ms          , Ms          , Ms          , Ms          , Aa          , Aa          , Qxua        , Qxua        , Qxua        , Qxua        , Qxua        , Qxua        , Qxua        
Xuce        , Xuce        , Xuce        , Xuce        , Xuce        , Xuce        , Xuce        , Xuce        , Xuce        , Xuce        , Xuce        , Xuce        , Xuce        , Xuce        , Xuce        , Xuce        , Xuce        , Aa          , Aa^Br|      , Aa          , 1 Urb       , Aa          , Aa          , Aa          , Aa          , Ms          , Ms          , Ms          , Ms^Xm       , Ms          , Aa          , Aa          , Aa          , Qxua        , Qxua        , Qxua        , Qxua        , Qxua        , Qxua        , Qxua        
Xuce        , Xuce        , Xuce        , Xuce        , Xuce        , Xuce        , Xuce        , Xuce        , Xuce        , Xuce        , Xuce        , Xuce        , Xuce        , Xuce        , Xuce        , Xuce        , Xuce        , Aa          , Aa^Br|      , Aa          , Urb         , Aa          , Aa          , Aa          , Aa          , Ms          , Ms          , Ms          , Ms          , Ms          , Aa          , Aa          , Aa          , Qxua        , Qxua        , Qxua        , Qxua        , Qxua        , Qxua        , Qxua        
Xuce        , Xuce        , Xuce        , Xuce        , Xuce        , Xuce        , Xuce        , Xuce        , Xuce        , Xuce        , Xuce        , Xuce        , Xuce        , Xuce        , Xuce        , Xuce        , Xuce        , Xuce        , Aa^Br|      , Aa          , Aa          , Aa          , Aa          , Aa          , Aa          , Ms          , Ms          , Ms          , Ms          , Ms          , Aa          , Aa          , Aa          , Qxua        , Qxua        , Qxua        , Qxua        , Qxua        , Qxua        , Qxua        
