border_size=1
usage=map

Hhd         , Hhd         , Hhd         , Hhd         , Hhd         , Hhd         , Hhd         , Hhd         , Hhd         , Hhd         , Hhd         , Hhd         , Rd          , Hhd         , Hhd         , Hhd         , Hhd         , Hhd         , Hhd         , Hhd         , Hhd         , Hhd         , Hhd         , Hhd         , Hhd         , Hhd         , Hhd         , Hhd         , Hhd         , Hhd         , Hhd         , Hhd         , Hhd         , Hhd         , Hhd         , Hhd         , Hhd         , Hhd         
Hhd         , Hhd         , Hhd         , Hhd         , Md          , Hhd         , Md          , Md          , Hhd         , Hhd         , Hhd         , Hhd         , Rd          , Hhd         , Hhd         , Hhd         , Hhd         , Hhd         , Hhd         , Hhd         , Hhd         , Hhd         , Md          , Hhd         , Md          , Hhd         , Md          , Hhd         , Md          , Md          , Md          , Md          , Md          , Hhd         , Hhd         , Hhd         , Hhd         , Hhd         
Hhd         , Hhd         , Md          , Md          , Md          , Md          , Md          , Hhd         , Hhd         , Hhd         , Dd          , Dd^Cd       , 3 Dd^Kd     , Dd^Cd       , Hhd         , Hhd         , Md          , Hhd         , Hhd         , Md          , Hhd         , Hhd         , Md          , Md          , Md          , Md          , Hhd         , Md          , Md          , Md          , Hhd         , Md          , Hhd         , Md          , Hhd         , Hhd         , Md          , Hhd         
Hhd         , Hhd         , Md          , Hhd         , Hhd         , Hhd         , Md          , Hhd         , Hhd         , Hhd         , Dd^Vdt      , Dd^Cd       , Rb          , Dd^Cd       , Dd          , Hhd         , Hhd         , Md          , Md          , Hhd         , Hhd         , Md          , Hhd         , Md          , Md          , Md          , Hhd         , Hhd         , Hhd         , Hhd         , Dd          , Dd          , Dd          , Hhd         , Dd          , Hhd         , Md          , Hhd         
Hhd         , Hhd         , Md          , Md          , Md          , Hhd         , Dd          , Md          , Md          , Hhd         , Md          , Rb          , Rb          , Rb          , Dd          , Dd          , Dd          , Md          , Hhd         , Hhd         , Hhd         , Hhd         , Hhd         , Hhd         , Hhd         , Md          , Md          , Md          , Md          , Hhd         , Dd          , Dd          , Dd^Edp      , Dd          , Dd          , Hhd         , Md          , Hhd         
Hhd         , Hhd         , Hhd         , Hhd         , Hhd         , Hhd         , Dd          , Hhd         , Dd          , Hhd         , Hhd         , Hhd         , Dd          , Rd          , Rd          , Rd          , Rd          , Hhd         , Re          , Dd^Vdt      , Re          , Re          , Re          , Hhd         , Md          , Md          , Hhd         , Hhd         , Hhd         , Hhd         , Dd          , Dd          , Dd          , Dd          , Md          , Md          , Hhd         , Hhd         
Hhd         , Hhd         , Hhd         , Hhd         , Hhd         , Hhd         , Hhd         , Hhd         , Hhd         , Hhd         , Hhd         , Hhd         , Rd          , Hd          , Hd          , Hd          , Hd          , Rd          , Re          , Re          , Re          , Dd^Vdt      , Hd          , Md          , Md          , Md          , Md          , Hhd         , Dd          , Dd          , Dd          , Dd          , Dd          , Dd          , Hd          , Md          , Md          , Hhd         
Hhd         , Dd          , Hhd         , Dd          , Dd          , Dd^Edp      , Dd          , Hhd         , Hhd         , Hhd         , Md          , Md          , Hhd         , Md          , Md          , Md          , Hhd         , Hd          , Dd          , Re          , Dd^Vdt      , Hd          , Hd          , Md          , Md          , Hhd         , Md          , Hhd         , Dd          , Dd          , Dd          , Dd          , Dd^Edp      , Dd          , Dd          , Hd          , Dd          , Dd          
Dd          , Dd          , Dd          , Dd          , Md          , Dd          , Dd          , Dd          , Dd          , Dd          , Hhd         , Md          , Md          , Md          , Md          , Md          , Hhd         , Hhd         , Dd          , Hd          , Hd          , Md          , Hhd         , Md          , Hd          , Dd          , Hhd         , Dd          , Dd          , Dd          , Dd          , Dd          , Dd^Hd       , Dd          , Dd          , Dd          , Dd          , Dd          
Dd          , Dd          , Dd          , Md          , Md          , Md          , Dd          , Dd          , Dd          , Hhd         , Hhd         , Md          , Md          , Md          , Md          , Md          , Hhd         , Rd          , Dd^Dc       , Dd          , Hhd         , Hhd         , Md          , Hd          , Hd          , Dd          , Dd          , Dd          , Dd          , Dd          , Dd          , Dd^Hd       , Dd          , Dd          , Dd          , Dd          , Dd          , Dd          
Dd          , Dd          , Dd          , Dd          , Dd          , Dd          , Dd          , Dd          , Dd          , Dd          , Hhd         , Hhd         , Hhd         , Hhd         , Hhd         , Hhd         , Hd          , Dd          , Rd          , Rd          , Hhd         , Hhd         , Hhd         , Dd          , Hhd         , Dd          , Hd          , Dd          , Dd          , Dd          , Dd          , Dd          , Dd          , Dd          , Dd          , Dd          , Dd          , Dd          
Dd          , Dd          , Dd^Edp      , Dd          , Dd^Hd       , Dd          , Dd^Edp      , Dd^Edp      , Dd          , Dd          , Hhd         , Dd          , Hhd         , Hhd         , Dd          , Dd          , Dd^Dc       , Dd          , Dd          , Dd          , Rd          , Hhd         , Hhd         , Hhd         , Hhd         , Hd          , Hd          , Dd          , Dd          , Dd          , Dd^Edp      , Dd          , Dd          , Dd          , Dd          , Dd          , Dd          , Dd          
Dd          , Dd          , Dd          , Dd^Hd       , Dd          , Dd          , Dd          , Dd          , Dd          , Dd          , Dd          , Dd          , Dd          , Dd          , Dd          , Dd          , Dd          , Dd          , Dd          , Dd          , Rd          , Dd          , Hd          , Hhd         , Hhd         , Hhd         , Hd          , Dd          , Dd          , Dd          , Dd          , Dd          , Dd          , Dd          , Dd          , Dd^Edp      , Dd          , Dd          
Dd          , Dd          , Dd^Hd       , Dd^Hd       , Dd          , Dd          , Dd          , Dd          , Dd          , Dd          , Dd          , Dd          , Dd^Edp      , Dd          , Dd          , Dd          , Dd          , Dd          , Dd          , Dd          , Rd          , Dd          , Dd          , Hhd         , Hhd         , Hhd         , Dd          , Hd          , Dd          , Dd          , Dd          , Dd          , Dd          , Dd          , Dd          , Dd          , Dd          , Dd          
Dd          , Dd          , Dd          , Dd          , Dd          , Dd          , Dd          , Dd          , Dd          , Dd          , Dd          , Dd          , Dd          , Dd          , Dd          , Dd          , Dd          , Dd          , Dd          , Dd          , Rd          , Dd          , Hd          , Hhd         , Hhd         , Hhd         , Hd          , Dd          , Dd          , Dd          , Dd          , Dd          , Dd          , Dd          , Dd          , Dd          , Dd          , Dd          
Dd          , Dd          , Dd          , Dd          , Dd          , Dd          , Dd          , Dd          , Dd          , Dd          , Dd          , Dd^Do       , Dd          , Dd          , Dd          , Dd          , Dd          , Dd          , Dd          , Rd          , Rd          , Rd          , Hd          , Hhd         , Hd          , Dd          , Dd          , Hd          , Dd          , Dd          , Dd          , Dd          , Dd          , Dd          , Dd          , Dd          , Dd          , Dd          
Dd          , Dd          , Dd          , Dd          , Dd          , Dd          , Dd          , Dd          , Dd          , Dd          , Dd          , Dd          , Dd          , Dd          , Dd          , Dd          , Dd          , Rd          , Rd          , Dd          , Dd          , Dd          , Rd          , Hd          , Dd          , Dd          , Dd          , Dd          , Dd          , Dd          , Dd          , Dd          , Dd          , Dd          , Dd          , Dd          , Dd          , Dd          
Dd          , Dd          , Dd          , Dd          , Dd          , Ds          , Dd          , Dd          , Dd          , Dd          , Hd          , Dd          , Dd          , Rd          , Dd          , Dd          , Dd          , Rd          , Dd          , Hd          , Hd          , Dd          , Rd          , Dd          , Ds          , Ds          , Ds          , Dd          , Dd          , Dd          , Dd          , Dd          , Dd          , Dd          , Dd          , Dd          , Dd          , Dd          
Dd          , Dd          , Dd          , Dd          , Dd^Edp      , Ds          , Dd          , Dd          , Dd          , Dd          , Hd          , Dd          , Rd          , Rd          , Dd          , Rd          , Rd          , Dd          , Dd^Vdt      , Hd          , Hd          , Hd          , Rd          , Rd          , Dd          , Dd          , Ds          , Dd          , Dd          , Dd          , Dd          , Dd          , Dd          , Dd          , Dd          , Dd          , Dd          , Dd          
Dd          , Dd          , Dd          , Dd          , Dd          , Dd          , Dd^Dc       , Dd          , Dd          , Hd          , Hd          , Hd          , Dd          , Dd          , Dd          , Rd          , Dd          , Dd          , Dd          , Hd          , Hd          , Dd          , Dd          , Dd          , Hd          , Hd          , Dd          , Dd          , Dd          , Dd          , Dd          , Dd          , Dd          , Dd          , Dd          , Dd          , Dd          , Dd          
Dd          , Dd          , Dd          , Dd          , Dd          , Dd          , Dd^Vdt      , Dd          , Dd          , Hd          , Hd          , Dd          , Ds          , Dd          , Dd          , Dd          , Dd          , Ds          , Dd          , Dd          , Dd^Vdt      , Dd          , Dd          , Rd          , Rd          , Hd          , Hd          , Dd          , Dd          , Dd^Edpp     , Dd          , Dd          , Dd          , Dd          , Dd          , Dd          , Dd          , Dd          
Dd          , Dd          , Dd^Vdt      , Dd          , Dd          , Dd          , Dd          , Dd          , Dd^Edp      , Dd          , Dd          , Dd          , Dd          , Ds          , Gs          , Gs          , Gs          , Gs          , Gs          , Dd          , Gll         , Rd          , Rd          , Dd          , Dd          , Md          , Hd          , Dd          , Dd          , Dd          , Dd          , Dd          , Dd          , Dd          , Dd          , Dd          , Dd          , Dd          
Dd          , Dd          , Dd          , Dd          , Gd          , Dd          , Dd          , Dd          , Dd          , Dd          , Dd          , Dd          , Gd          , Gd          , Ww          , Ww^Bw|      , Ww          , Ww^Bw|      , Ww          , Gs          , Wwf         , Gll         , Gd          , Ds          , Dd          , Md          , Hd          , Dd          , Dd          , Dd          , Dd          , Dd          , Dd^Edpp     , Dd^Es       , Dd          , Dd          , Dd          , Dd          
Dd          , Dd          , Gd          , Gd          , Gd          , Gd          , Rd          , Dd          , Dd          , Dd          , Dd          , Dd          , Gs          , Ww          , Gs          , Rp          , Ce          , Rp          , Gs          , Ww          , Ww          , Wwf         , Gd          , Dd          , Dd          , Hd          , Hd          , Dd          , Dd          , Dd          , Dd          , Dd          , Dd          , Dd          , Dd          , Dd          , Dd          , Dd          
Gs          , Gs          , Gg          , Gs          , Gs          , Gs          , Ww          , Gs          , Gs          , Dd          , Gs          , Gs          , Ww          , Ww          , Gs          , Re          , Re          , Re          , Dd^Dc       , Gs          , Gd          , Gd          , Gd          , Ds          , Dd          , Dd          , Dd          , Dd          , Dd          , Dd^Edpp     , Dd          , Dd          , Dd          , Dd          , Dd^Hd       , Dd          , Dd          , Dd          
Gs          , Gd          , Ww          , Ww          , Ww          , Ww          , Gs          , Ww          , Ww          , Gs          , Ww          , Rd          , Ww          , Ww          , Gd^Gvs      , Re          , Gs^Ft       , Gs^Ft       , Re          , Gs          , Md          , Gd          , Hd          , Dd          , Ds          , Ds          , Dd          , Dd          , Dd          , Dd          , Dd^Es       , Dd          , Dd          , Dd          , Dd          , Dd^Edp      , Dd          , Dd          
Ww          , Ww          , Hh          , Hhd         , Hhd         , Gs          , Gs^Efm      , Gs          , Ww          , Ww          , Ww          , Ww          , Gd^Gvs      , Gd^Gvs      , Gd^Gvs      , Re          , Dd          , Dd^Vda      , Re          , Hd          , Hd          , Hd          , Md          , Hd          , Dd          , Ds          , Ds          , Ds          , Dd          , Ds          , Dd          , Ds          , Dd          , Dd          , Dd          , Dd          , Dd          , Dd          
Gs          , Gs          , Gs          , Hhd         , Hhd         , 4 Hd        , Ww          , Ww          , Gd          , Ww          , Gd          , Gg^Efm      , Gs          , Gd^Gvs      , Dd          , Re          , Re          , Re          , Gs          , Hd          , Re          , Dd^Vda      , Md          , Hd          , Dd          , Ds          , Ds^Es       , Ds          , Ds          , Ds^Es       , Ds          , Ds          , Dd          , Dd^Hd       , Dd^Es       , Dd          , Dd          , Dd          
Dd          , Gs          , Hhd         , Hhd         , Hhd         , Ww          , Gs^Em       , Gd          , Gd          , Gd          , Dd^Vda      , Gs          , Ce          , Rd          , Gs          , Chr         , Ch          , Chr         , Re          , Re          , Re          , Md          , Md          , Hd          , Ds          , Dd          , Ds          , Ds          , Ds          , Ds          , Dd          , Dd          , Dd          , Dd          , Dd          , Dd          , Dd          , Dd          
Hd          , Hhd         , Dd          , Hhd         , Hd          , Ww          , Gs          , Dd^Vda      , Gll         , Rd          , Rd          , Rd          , Rd          , Rd          , Dd^Vda      , Chr         , 1 Kh        , Dd          , Re          , Re          , Dd          , Hd          , Hd          , Ds          , Dd          , Dd          , Dd          , Dd          , Dd          , Dd^Es       , Dd          , Dd          , Dd          , Dd          , Dd          , Dd          , Dd          , Dd          
Hd          , Hd          , Dd          , Hd          , Hd          , Ww          , Ww          , Rd          , Gs^Em       , Gll         , Dd^Vda      , Rd          , Ce          , Rd          , Gs          , Gs          , Chr         , Dd          , Re          , Dd          , Dd          , Gs          , Dd          , Dd^Vdt      , Dd          , Dd          , Dd          , Dd          , Dd          , Dd          , Dd          , Dd          , Dd          , Dd          , Dd          , Dd          , Dd          , Dd          
Dd          , Dd          , Dd          , Dd          , Gd          , Gs          , Gs          , Ww          , Ww          , Gs          , Gd          , Gs          , Gll         , Gs          , Rd          , Dd          , Gs          , Gs          , Dd          , Gs          , Ce          , Dd          , Dd          , Dd          , Dd          , Dd          , Dd          , Dd          , Dd          , Dd          , Dd          , Dd          , Dd          , Dd          , Dd          , Dd          , Dd          , Dd          
Dd          , Dd          , Dd          , Dd          , Gd          , Gd          , Gs          , Rd          , Wwf         , Wwf         , Gd          , Gll         , Dd          , Dd          , Dd          , Dd^Vda      , Dd          , Rd          , Rd          , Rd          , Rd          , Rd          , Dd          , Dd          , Dd          , Dd          , Dd          , Dd          , Dd          , Dd          , Dd          , Dd^Edp      , Dd          , Dd          , Dd          , Dd          , Dd          , Dd          
Dd          , Dd          , Dd          , Dd          , Dd          , Gd^Edpp     , Gd          , Gs          , Gd          , Gd          , Ce          , Dd          , Dd          , Ds          , Dd^Edpp     , Dd          , Rd          , Rd          , Dd^Vda      , Dd          , Ce          , Dd          , Rd          , Rd          , Dd          , Dd^Vdt      , Dd          , Dd          , Dd          , Dd          , Dd          , Dd          , Dd          , Dd          , Dd          , Dd          , Dd          , Dd          
Dd          , Dd          , Dd          , Dd          , Dd          , Dd          , Dd          , Gd          , Gd          , Gd^Edpp     , Dd          , Dd^Edpp     , Dd          , Ds          , Rd          , Dd          , Dd          , Rd          , Dd          , Dd          , Dd          , Dd          , Dd          , Dd          , Dd          , Dd          , Dd          , Dd          , Dd          , Dd          , Dd          , Dd          , Dd          , Dd          , Dd^Edp      , Dd          , Dd          , Dd          
Dd          , Dd          , Dd          , Dd          , Dd          , Dd^Vdt      , Dd          , Dd          , Dd          , Dd          , Dd          , Dd          , Dd          , Dd          , Dd          , Dd          , Ce          , Rd          , Ce          , Dd          , Dd          , Dd          , Dd          , Dd          , Dd          , Dd          , Dd          , Dd^Dc       , Dd          , Dd          , Dd          , Dd          , Dd          , Dd          , Dd          , Dd          , Dd          , Dd          
Dd          , Dd          , Dd          , Dd          , Dd          , Dd          , Dd          , Dd          , Dd          , Dd          , Dd          , Dd          , Dd          , Dd          , Hd          , Dd          , Dd          , Re          , Dd          , Dd          , Dd          , Dd          , Dd^Do       , Dd          , Dd          , Dd          , Dd          , Dd          , Dd^Dr       , Dd          , Dd          , Dd          , Dd          , Dd          , Dd          , Dd          , Dd^Edp      , Dd          
Dd          , Dd          , Dd          , Dd          , Dd          , Dd          , Dd          , Dd          , Dd          , Dd          , Dd          , Dd          , Dd          , Dd          , Md          , Hd          , Hd          , Rd          , Dd          , Dd          , Dd          , Dd^Dc       , Dd          , Dd          , Dd          , Dd          , Hd          , Hd^Dr       , Hd          , Hd^Dr       , Dd          , Dd          , Dd          , Dd          , Dd          , Dd          , Dd          , Dd          
Dd          , Dd          , Dd          , Dd          , Hd          , Dd          , Dd          , Dd          , Dd          , Dd          , Dd          , Dd          , Dd          , Dd          , Md          , Md          , Hd          , Rd          , Dd          , Re          , Rd          , Dd          , Dd^Do       , Dd          , Dd^Dc       , Dd          , Hd          , Dd          , Dd          , Dd          , Dd          , Dd          , Dd          , Dd          , Dd          , Dd          , Dd          , Dd          
Dd          , Dd          , Dd          , Hd          , Dd          , Hd          , Hd          , Dd          , Dd          , Dd          , Dd          , Dd          , Dd          , Dd          , Dd          , Md^Xm       , Hd          , Dd          , Dd          , Dd          , Dd          , Re          , Rd          , Dd          , Dd          , Hd          , Hd          , Dd          , Dd          , Dd          , Dd          , Dd          , Dd          , Dd          , Dd          , Dd          , Dd          , Dd          
Hd          , Dd          , Hd          , Hd          , Hd          , Dd          , Dd          , Dd          , Dd          , Dd          , Dd          , Dd          , Dd          , Dd          , Dd          , Dd          , Dd          , Hd          , Hd          , Dd          , Dd          , Dd          , Dd          , Rd          , Dd          , Hd          , Hd          , Hd          , Dd          , Dd          , Dd          , Dd          , Dd          , Dd          , Dd          , Dd          , Dd          , Dd          
Dd          , Hd          , Dd          , Hd          , Hd          , Dd          , Hd          , Hd          , Hd          , Dd          , Dd          , Dd          , Dd          , Dd          , Dd          , Dd          , Dd          , Dd          , Hd          , Dd          , Dd          , Dd^Dc       , Dd          , Dd          , Dd          , Hd          , Hd          , Hd          , Dd          , Dd          , Dd          , Dd          , Dd          , Dd          , Dd^Edp      , Dd          , Dd          , Dd          
Dd          , Dd          , Dd          , Dd          , Dd          , Hd          , Dd          , Md          , Hd          , Dd          , Dd          , Dd          , Dd          , Dd          , Dd^Hd       , Dd          , Dd          , Dd          , Dd          , Dd          , Dd          , Dd          , Dd          , Re          , Dd          , Dd          , Hd          , Hd          , Dd          , Dd          , Dd          , Dd          , Dd          , Dd          , Dd          , Dd          , Dd          , Dd          
Dd          , Dd          , Dd          , Dd          , Dd          , Dd          , Dd          , Dd          , Hd          , Hd          , Dd          , Dd          , Dd          , Dd          , Dd          , Dd^Hd       , Dd^Hd       , Dd          , Dd          , Dd          , Dd          , Dd          , Dd          , Rd          , Dd          , Dd          , Dd          , Dd          , Dd          , Dd          , Dd          , Dd          , Dd^Hd       , Dd          , Dd          , Dd          , Dd          , Dd          
Dd          , Dd          , Dd          , Dd          , Dd          , Dd          , Dd          , Dd          , Dd          , Dd          , Dd          , Dd          , Dd          , Dd          , Dd          , Dd^Hd       , Dd          , Dd          , Dd          , Dd          , Dd          , Dd          , Dd          , Dd          , Rd          , Dd          , Dd          , Dd          , Dd          , Dd          , Dd          , Dd^Hd       , Dd          , Dd          , Dd          , Dd          , Dd          , Dd          
Dd          , Dd          , Dd          , Dd          , Dd          , Dd          , Dd          , Dd          , Dd          , Dd          , Dd          , Dd          , Dd^Edp      , Dd          , Dd          , Dd          , Dd          , Dd          , Dd          , Dd          , Dd          , Dd          , Dd          , Dd          , Dd          , Dd          , Dd          , Dd          , Dd          , Dd          , Dd          , Dd          , Dd          , Dd          , Dd          , Dd          , Dd          , Dd          
Dd          , Dd          , Dd          , Dd          , Dd          , Dd          , Dd          , Dd          , Dd          , Dd          , Dd          , Dd          , Dd          , Dd          , Dd          , Dd          , Dd          , Dd          , Dd          , Dd          , Dd          , Dd          , Dd          , Dd          , Dd          , Rd          , Dd          , Dd          , Dd          , Dd^Edp      , Dd          , Dd          , Dd          , Dd          , Dd          , Dd          , Hd          , Dd          
Dd          , Dd          , Dd          , Dd          , Dd          , Dd          , Dd          , Dd          , Dd          , Dd          , Dd          , Dd          , Dd          , Dd          , Dd          , Dd          , Dd          , Dd          , Dd          , Dd          , Hd          , Hd          , Hd          , Hd          , Hd          , Dd          , Rd          , Rd          , Dd          , Dd          , Dd          , Dd          , Dd          , Dd          , Dd          , Hd          , Md          , Hd          
Dd          , Dd          , Dd          , Dd^Edp      , Dd          , Dd          , Dd          , Dd          , Dd          , Dd          , Dd          , Dd          , Dd          , Dd          , Dd          , Dd          , Dd          , Dd          , Dd          , Dd          , Dd          , Hd          , Hd          , Hd          , Hd          , Dd          , Dd          , Dd          , Re          , Rd          , Dd          , Dd          , Dd          , Dd          , Dd          , Dd          , Md          , Md          
Dd          , Dd          , Dd          , Dd          , Dd          , Dd          , Dd          , Dd          , Dd          , Dd          , Dd          , Dd          , Dd^Edp      , Dd          , Dd          , Dd          , Hd          , Dd          , Hd          , Dd          , Hd          , Dd          , Hd          , Hd          , Hd          , Dd          , Dd          , Dd          , Dd          , Dd          , Rd          , Re          , Dd          , Dd          , Dd          , Dd          , Hd          , Md          
Dd          , Dd          , Dd          , Dd          , Dd          , Dd          , Dd          , Dd          , Dd          , Dd          , Dd          , Dd          , Dd          , Dd          , Dd          , Dd          , Dd          , Hd          , Dd          , Hd          , Hd          , Hd          , Hd          , Hd          , Dd          , Dd          , Dd          , Dd          , Dd          , Dd          , Dd          , 2 Rd        , Dd          , Dd          , Dd          , Dd          , Dd          , Dd          
Dd          , Dd          , Dd          , Dd          , Dd          , Dd          , Dd          , Dd          , Dd          , Dd          , Dd          , Dd          , Dd          , Dd          , Dd          , Dd          , Dd          , Dd          , Dd          , Dd          , Dd          , Hd          , Dd          , Dd          , Dd          , Dd          , Dd          , Dd          , Dd          , Dd          , Dd          , Dd          , Rd          , Rd          , Dd          , Dd          , Dd          , Dd          
Dd          , Dd          , Dd          , Dd          , Dd          , Dd          , Dd          , Dd          , Dd          , Dd          , Dd          , Dd          , Dd          , Dd          , Dd          , Dd          , Dd          , Dd          , Dd          , Dd          , Dd          , Dd          , Dd          , Dd          , Dd          , Dd          , Dd          , Dd          , Dd          , Dd          , Dd          , Dd          , Dd          , Dd          , Re          , Rd          , Dd          , Dd          
Dd          , Dd          , Dd          , Dd          , Dd          , Dd          , Dd          , Dd          , Dd          , Dd          , Dd          , Dd          , Dd          , Dd          , Dd          , Dd          , Dd          , Dd          , Dd          , Dd          , Dd          , Dd          , Dd          , Dd          , Dd          , Dd          , Dd          , Dd          , Dd          , Dd          , Dd          , Dd          , Dd          , Dd          , Dd          , Dd          , Rd          , Rd          
