border_size=1
usage=map

Md          , Md          , Md          , Md          , Md          , Md          , Md          , Md          , Md          , Md          , Md          , Md          , Md          , Md          , Md          , Md          , Md          , Md          , Md          , Md          , Md          , Md          , Md          , Md          , Md          , Md          , Md          , Md          , Md          , Hd          , Rd          , Hd          , Md          , Md          , Md          , Md          , Md          , Md          , Md          , Md          , Md          , Md          , Md          , Md          , Md          , Md          , Md          , Md          , Md          , Md          , Md          , Md          , Md          
Md          , Md          , Md          , Md          , Md          , Md          , Md          , Md          , Md          , Md          , Md          , Md          , Md          , Md          , Md          , Md          , Md          , Md          , Md          , Md          , Md          , Md          , Md          , Md          , Md          , Md          , Md          , Md          , Hd          , Hd^Dr       , Rd          , Hhd         , Md          , Md          , Md          , Md          , Md          , Md          , Md          , Md          , Md          , Md          , Md          , Md          , Md          , Md          , Md          , Md          , Md          , Md          , Md          , Md          , Md          
Md          , Md          , Md          , Md          , Md          , Md          , Md          , Md          , Md          , Md          , Md          , Md          , Md          , Md          , Md          , Md          , Md          , Md          , Md          , Md          , Md          , Md          , Md          , Md          , Md          , Md          , Md          , Hd          , Hhd         , Hhd         , Rd          , Hhd         , Md          , Md          , Md          , Md          , Md          , Md          , Md          , Md          , Md          , Md          , Md          , Md          , Md          , Md          , Md          , Md          , Md          , Md          , Md          , Md          , Md          
Md          , Md          , Md          , Md          , Md          , Md          , Md          , Md          , Md          , Md          , Md          , Md          , Md          , Md          , Md          , Md          , Md          , Md          , Md          , Md          , Md          , Md          , Md          , Md          , Md          , Md          , Md          , Hhd         , Rd          , Rd          , Rd          , Md          , Md          , Md          , Md          , Md          , Md          , Md          , Md          , Md          , Md          , Md          , Md          , Md          , Md          , Md          , Md          , Md          , Md          , Md          , Md          , Md          , Md          
Md          , Md          , Md          , Md          , Md          , Md          , Md          , Md          , Md          , Md          , Md          , Md          , Md          , Md          , Md          , Md          , Md          , Md          , Md          , Md          , Md          , Md          , Md          , Md          , Md          , Md          , Hhd         , Rd          , Rd          , Hd^Dr       , Md          , Md          , Md          , Md          , Md          , Md          , Md          , Md          , Md          , Md          , Md          , Md          , Md          , Md          , Md          , Md          , Md          , Md          , Md          , Md          , Md          , Md          , Md          
Md          , Md          , Md          , Md          , Md          , Md          , Md          , Md          , Md          , Md          , Md          , Md          , Md          , Md          , Md          , Md          , Md          , Md          , Md          , Md          , Md          , Md          , Md          , Md          , Md          , Md          , Hhd         , Rd          , Hhd         , Md          , Md          , Md          , Md          , Md          , Md          , Md          , Md          , Md          , Md          , Md          , Md          , Md          , Md          , Md          , Md          , Md          , Md          , Md          , Md          , Md          , Md          , Md          , Md          
Md          , Md          , Md          , Md          , Md          , Md          , Md          , Md          , Md          , Md          , Md          , Md          , Md          , Md          , Md          , Md          , Md          , Md          , Md          , Md          , Md          , Md          , Md          , Md          , Md          , Md          , Hhd         , Rd          , Rd          , Hhd         , Md          , Md          , Md          , Md          , Md          , Md          , Md          , Md          , Md          , Md          , Md          , Md          , Md          , Md          , Md          , Md          , Md          , Md          , Md          , Md          , Md          , Md          , Md          
Md          , Md          , Md          , Md          , Md          , Md          , Md          , Md          , Md          , Md          , Md          , Md          , Md          , Md          , Md          , Md          , Md          , Md          , Md          , Md          , Md          , Md          , Md          , Md          , Md          , Md          , Hd          , Hhd         , Rd          , Hhd         , Md          , Md          , Md          , Md          , Md          , Md          , Md          , Md          , Md          , Md          , Md          , Md          , Md          , Md          , Md          , Md          , Md          , Md          , Md          , Md          , Md          , Md          , Md          
Md          , Md          , Md          , Md          , Md          , Md          , Md          , Md          , Md          , Md          , Md          , Md          , Md          , Md          , Md          , Md          , Md          , Md          , Md          , Md          , Md          , Md          , Md          , Md          , Md          , Md          , Hd          , Hhd         , Rd          , Rd          , Md          , Md          , Md          , Md          , Md          , Md          , Md          , Md          , Md          , Md          , Md          , Md          , Hhd         , Md          , Hhd         , Md          , Hhd         , Md          , Hhd         , Md          , Hhd         , Md          , Md          
Md          , Md          , Md          , Md          , Md          , Md          , Md          , Md          , Md          , Md          , Md          , Md          , Md          , Md          , Md          , Md          , Md          , Md          , Md          , Md          , Md          , Md          , Md          , Md          , Md          , Md          , Md          , Md          , Dd          , Rd^Esd      , Rd          , Dd^Esd      , Md          , Md          , Md          , Md          , Md          , Md          , Md          , Md          , Md          , Md          , Hhd         , Hhd         , Hhd         , Hhd         , Hhd         , Hhd         , Hhd         , Hhd         , Hhd         , Hhd         , Hhd         
Md          , Md          , Md          , Md          , Md          , Hhd         , Md          , Hhd         , Md          , Hhd         , Hhd         , Hhd         , Md          , Md          , Md          , Md          , Md          , Md          , Md          , Md          , Md          , Md          , Md          , Md          , Md          , Md          , Md          , Md          , Dd          , Dd          , Rd          , Rd          , Gd          , Md          , Gll         , Md          , Md          , Md          , Md          , Md          , Hhd         , Hhd         , Hhd         , Hhd         , Hhd         , Hhd         , Hhd         , Hhd         , Hhd         , Hhd         , Hhd         , Hhd         , Hhd         
Md          , Md          , Md          , Hhd         , Hhd         , Hhd         , Hd          , Hhd         , Hhd         , Hhd         , Hhd         , Hhd         , Hhd         , Hhd         , Hhd         , Hhd         , Md          , Md          , Gd          , Md          , Gll         , Md          , Md          , Md          , Md          , Md          , Md          , Md          , Gs          , Gs          , Gs          , Rd          , Gs          , Gll         , Gd          , Gll         , Gll         , Md          , Gd          , Hhd         , Hhd         , Hhd         , Hhd         , Hhd         , Hhd         , Hhd         , Hhd         , Hhd         , Hhd         , Hhd         , Hhd         , Hhd         , Hhd         
Md          , Hhd         , Hhd         , Hhd         , Hd          , Hd          , Gs          , Gs          , Gg          , Gs          , Gs          , Gs          , Gs          , Hd          , Gs          , Hd          , Gs          , Gd          , Gd          , Gd          , Gs          , Gd          , Gll         , Gll         , Gll         , Md          , Gs          , Gs          , Sm          , Gs^Edp      , Gs          , Rd          , Gs          , Gs          , Gs^Edp      , Gd          , Gs          , Gll         , Gs          , Wwf         , Wwf         , Wwf         , Wwr         , Wwr         , Wwf         , Wwr         , Wwf         , Wwf         , Wwf         , Wwf         , Wwf         , Hhd         , Hhd         
Hd          , Md          , Gs          , Hd          , Gg          , Gs          , Gg          , Gg          , Ww          , Ww          , Ww          , Gs          , 1 Gs        , Gs          , Gg          , Gg          , Gg          , Gs          , Gs          , Gs          , Gs          , Gs          , Gs^Efm      , Gll         , Gs          , Gs          , Dd^Vdt      , Sm          , Sm          , Sm          , Chr         , 4 Khr       , Chr         , Gs          , Gs          , Gs          , Ww          , Gs^Efm      , Ww          , Ww          , Ww          , Ww          , Ww          , Ww          , Ww          , Ww          , Ww          , Wwr         , Ww          , Wwr         , Wwr         , Wwf         , Ww          
Gs          , Gs          , Gs          , Gg          , Ww          , Ww          , Ww          , Ww          , Ww          , Ww          , Ww          , Ww          , Ww          , Ww          , Ww          , Ww          , Ww          , Ww          , Ww          , Ww          , Ww          , Gs^Efm      , Gg^Efm      , Gs          , Gs          , Gs          , Gg          , Gg          , Gg^Efm      , Gs          , Chw         , Ww          , Chw         , Ww          , Ww          , Ww          , Ww          , Ww          , Ww          , Ww          , Ww          , Ww          , Ww          , Ww          , Ww          , Ww          , Ww^Ewf      , Ww^Ewf      , Ww^Ewf      , Ww          , Ww          , Ww          , Ww          
Ww          , Gs          , Ww          , Ww          , Ww          , Ww          , Wo          , Wo          , Wo          , Wo          , Wo          , Wo          , Wo          , Ww          , Ww          , Ww          , Ww          , Ww          , Ww          , Ww^Ewf      , Ww^Ewf      , Ww          , Ww          , Ww          , Ww          , Ww          , Ww          , Ww          , Ww          , Ww          , Ww          , Ww          , Ww          , Ww          , Ww          , Ww          , Ww^Ewf      , Ww^Ewf      , Ww^Ewf      , Ww^Ewf      , Ww^Ewf      , Ww          , Ww          , Ww          , Ww          , Ww          , Ww          , Ww^Ewf      , Ww          , Ww          , Ww          , Ww          , Ww          
Wo          , Wo          , Wo          , Wo          , Wo          , Wo          , Wo          , Wo          , Ww          , Ww          , Ww          , Ww          , Ww          , Ww          , Gg          , Ww          , Ww          , Ww          , Ww          , Ww^Ewf      , Ww          , Ww^Ewf      , Ww          , Ww          , Ww          , Ww          , Ww          , Ww          , Ww          , Ww          , Ww          , Ww          , Ww          , Ww          , Ww          , Ww          , Ww^Ewf      , Ww^Ewf      , Gs          , Ww^Ewf      , Wwf         , Wwr         , Wwr         , Wwr         , Wwf         , Ww          , Wwr         , Ww          , Wwr         , Ww          , Wwf         , Ww          , Ww          
Wo          , Wo          , Ww          , Ww          , Ww          , Ww          , Ww          , Ww          , Gs          , Ww          , Gs          , Ww          , Gs          , Gg          , Gg          , Gg          , Gs          , Ww          , Hhd         , Hhd         , Hhd         , Ww          , Hhd         , Ww          , Gg          , Ww          , Ww          , Ww          , Ww          , Ww          , Wwf         , Ww          , Wwf         , Ww          , Wwf         , Wwf         , Gs^Efm      , Gs^Efm      , Gs          , Gs          , Hd          , Wwf         , Wwf         , Wwf         , Hd          , Wwf         , Wwf         , Wwf         , Wwf         , Wwf         , Wwf         , Wwf         , Hd          
Ww          , Ww          , Gs          , Hd          , Hd          , Gs          , Gs          , Gs^Efm      , Gs          , Gs          , Gs          , Gs          , Gd          , Dd          , Hhd         , Hhd         , Hhd         , Hhd         , Hhd         , Hhd         , Hhd         , Hhd         , Hhd         , Hhd         , Hhd         , Gg^Efm      , Gs          , Gg^Efm      , Gs          , Wwf         , Wwf         , Wwf         , Sm          , Dd^Kd       , Sm          , Sm          , Gs          , Gs          , Gd          , Gs          , Hhd         , Hhd         , Hhd         , Hd          , Hhd         , Hd          , Hhd         , Wwf         , Hhd         , Hd          , Hhd         , Hd          , Hhd         
Zw          , Gs          , Gd          , Gs          , Gd          , Gd          , Gd          , Gd          , Hd          , Hd          , Gd          , Gd          , Dd          , Dd          , Dd          , Dd          , Hhd         , Hhd         , Hhd         , Hhd         , Hhd         , Hhd         , Hhd         , Hhd         , Hhd         , Hhd         , Gs          , 2 Gs        , Gs          , Sm          , Sm          , Sm          , Dd^Cd       , Sm          , Dd^Cd       , Dd^Cd       , Dd^Vdt      , Gs          , Md          , Gd          , Md          , Hhd         , Hhd         , Hhd         , Hhd         , Hhd         , Hhd         , Hhd         , Hhd         , Hhd         , Hhd         , Hhd         , Hhd         
Zw          , Gd          , Gd          , Gd          , Hhd         , Hhd         , Gd          , Hhd         , Hhd         , Hhd         , Hhd         , Hhd         , Hhd         , Hhd         , Hhd         , Hhd         , Hhd         , Hhd         , Md          , Md          , Md          , Hhd         , Hhd         , Hhd         , Hhd         , Hhd         , Gs^Edp      , 3 Gs        , Gs          , Gs          , Gs          , Gs          , Gs          , Gs          , Gs          , Gs          , Gd          , Gd          , Md          , Md          , Md          , Md          , Md          , Hhd         , Md          , Hhd         , Md          , Md          , Hhd         , Hhd         , Hhd         , Hhd         , Md          
Zw          , Zw          , Zw          , Zw          , Gd          , Hhd         , Gd          , Hhd         , Zw          , Md          , Md          , Hhd         , Md          , Hhd         , Hhd         , Md          , Hhd         , Md          , Md          , Md          , Md          , Md          , Md          , Hhd         , Md          , Gs          , Gs          , Gs          , Gs          , Dd^Vdt      , Gs          , Gs          , Gs          , Gs^Edp      , Gd          , Gd          , Md          , Md          , Md          , Md          , Md          , Md          , Md          , Md          , Md          , Md          , Md          , Md          , Md          , Md          , Md          , Md          , Md          
Md          , Md          , Md          , Zw          , Zw          , Gd          , Gd          , Gd          , Zw          , Zw          , Md          , Md          , Md          , Md          , Md          , Hhd         , Hhd         , Md          , Md          , Md          , Md          , Md          , Md          , Md          , Md          , Md          , Md          , Md          , Md          , Gs^Gvs      , Gs^Gvs      , Md          , Md          , Md          , Md          , Md          , Md          , Md          , Md          , Md          , Md          , Md          , Md          , Md          , Md          , Md          , Md          , Md          , Md          , Md          , Md          , Md          , Md          
Md          , Md          , Md          , Md          , Md          , Md          , Md          , Md          , Md          , Zw          , Md          , Md          , Md          , Md          , Md          , Md          , Md          , Md          , Md          , Md          , Md          , Md          , Md          , Md          , Md          , Md          , Md          , Md          , Md          , Md          , Md          , Md          , Md          , Md          , Md          , Md          , Md          , Md          , Md          , Md          , Md          , Md          , Md          , Md          , Md          , Md          , Md          , Md          , Md          , Md          , Md          , Md          , Md          
Md          , Md          , Md          , Md          , Md          , Md          , Md          , Md          , Md          , Md          , Md          , Md          , Md          , Md          , Md          , Md          , Md          , Md          , Md          , Md          , Md          , Md          , Md          , Md          , Md          , Md          , Md          , Md          , Md          , Md          , Md          , Md          , Md          , Md          , Md          , Md          , Md          , Md          , Md          , Md          , Md          , Md          , Md          , Md          , Md          , Md          , Md          , Md          , Md          , Md          , Md          , Md          , Md          
Md          , Md          , Md          , Md          , Md          , Md          , Md          , Md          , Md          , Md          , Md          , Md          , Md          , Md          , Md          , Md          , Md          , Md          , Md          , Md          , Md          , Md          , Md          , Md          , Md          , Md          , Md          , Md          , Md          , Md          , Md          , Md          , Md          , Md          , Md          , Md          , Md          , Md          , Md          , Md          , Md          , Md          , Md          , Md          , Md          , Md          , Md          , Md          , Md          , Md          , Md          , Md          , Md          
