border_size=1
usage=map

Xol         , Xol         , Rp          , Xos         , Xos         , Xos         , Xos         , Xos         , Xos         , Xos         , Xos         , Xos         , Xol         , Xos         , Xos         , Xos         , Xos         , Xos         , Xol         
Rp          , Rp          , Rp          , Rp          , Rp          , Rp          , Rp          , Rp          , Rp          , Rp          , Rp          , Rp          , Rp          , Rp          , Rp          , Rp          , Rp          , Rp          , Xol         
Xol         , Rp          , Rp          , Rp          , Rp          , Rp          , Rp          , Rp          , Cv          , Cv          , Cv          , Rp          , Rp          , Rp          , Rp          , Rp          , Rp          , Rp          , Xol         
Xol         , Rp          , Rp          , Rp          , Rp          , 3 Kv        , Rp          , Cv          , Gg^Efm      , 2 Kv        , Gg^Efm      , Cv          , Rp          , 4 Kv        , Rp          , Rp          , Rp          , Rp          , Xol         
Xol         , Rp          , Rp          , Rp          , Rp^Fou      , Rp          , Rp          , Cv          , Gg^Efm      , Gg^Efm      , Gg^Efm      , Cv          , Rp          , Rp          , Rp^Fou      , Rp          , Rp          , Rp          , Xol         
Xol         , Rp          , Cv          , Rp          , Rp          , Rp          , Rp          , Cv          , Rp          , Gg^Efm      , Rp          , Cv          , Rp          , Rp          , Rp          , Rp          , Cv          , Rp          , Xol         
Xol         , Rp          , Cv          , Cv          , Rp          , Rp          , Rp          , Rp          , Rp          , Rp          , Rp          , Rp          , Rp          , Rp          , Rp          , Cv          , Cv          , Rp          , Xol         
Xol         , Rp          , Cv          , Cv          , Rp          , Rp          , Rp          , Rp          , Rp          , 1 Rp        , Rp          , Rp          , Rp          , Rp          , Rp          , Cv          , Cv          , Rp          , Xol         
Xol         , Rp          , Rp          , Rp          , Rp          , Rp          , Rp          , Rp          , Rp          , Rp          , Rp          , Rp          , Rp          , Rp          , Rp          , Rp          , Rp          , Rp          , Xol         
Xol         , Rp          , Rp          , Rp          , Rp          , Rp          , Rp          , Rp          , Rp          , Qxua        , Rp          , Rp          , Rp          , Rp          , Rp          , Rp          , Rp          , Rp          , Xol         
Xol         , Rp          , Rp          , Rp          , Rp          , Rp          , Rp          , Rp          , Rp          , 5 Rp        , Rp          , Rp          , Rp          , Rp          , Rp          , Rp          , Rp          , Rp          , Xol         
Xol         , Rp          , Rp          , Rp          , Rp          , Rp          , Rp          , Rp          , Rp          , Rp          , Rp          , Rp          , Rp          , Rp          , Rp          , Rp          , Rp          , Rp          , Xol         
Xol         , Rp          , Rp          , Rp          , Rp          , Rp          , Rp          , Rp          , Rp          , Rp          , Rp          , Rp          , Rp          , Rp          , Rp          , Rp          , Rp          , Rp          , Xol         
