border_size=1
usage=map

Gd          , Gd          , Gd          , Gd          , Gd          , Gd          , Gd          , Gd          , Gd          , Gd          , Gd          , Rb          , Wwg         , Wwg         , Wwg         , Rb          , Gd          , Gd          , Gd          , Gd          , Gd          , Gd          , Gd          , Gd          , Gd          , Gd          
Gd          , Gd          , Gd          , Gd          , Gd          , Gd          , Gd^Es       , Gd          , Gd          , Gd          , Gd          , Rb          , Wwg         , Wwg         , Wwg         , Rb          , Gd          , Gd          , Gd          , Gd          , Gd          , Gd          , Gd          , Gd          , Gd          , Gd          
Gd          , Gd          , Gd          , Gd          , Gd          , Gd          , Gd          , Gd          , Gd          , Gd          , Gd          , Rb          , Wwg         , Wwg         , Wwg         , Rb          , Rb          , Gd          , Gd          , Gd          , Gd          , Gd^Wm       , Gd          , Gd          , Gd          , Gd          
Gd          , 5 Gd        , Gd          , Gd          , Gd          , Gd          , Gd          , Gd          , Gd          , Gd          , Gd          , Rb          , Wwg         , Wwg         , Wwg         , Wwg         , Rb          , Gd          , Gd^Es       , Gd^Eff      , Gd^Eff      , Gd          , Gd          , Gd^Es       , Gd          , Gd          
Gd          , Gd          , Gd          , Gd          , Gd^Eff      , Gd^Eff      , Gd^Eff      , Gd          , Gd          , Gd          , Gd          , Rb          , Rb^Es       , Wwg         , Wwg         , Wwg         , Wwg         , Rb^Es       , Rb          , Gd          , Gd          , Gd          , Gd          , Gd          , Gd          , Gd          
Gd          , Gd^Es       , Gd^Eff      , Gd^Eff      , Gd          , Gd^Es       , Gd^Eff      , Gd^Eff      , Gd          , Gd          , Gd          , Gd          , Gd          , Rb          , Rb          , Wwg         , Wwg         , Wwg         , Rb          , Rb          , Rb          , Gd          , Gd          , Gd^Eff      , Gd^Eff      , Gd          
Gd^Eff      , Gd^Eff      , Gd          , Gd          , Gd^Eff      , Gd^Eff      , Gd          , Gd          , Gd          , Gd          , Gd          , Gd          , Gd          , Gd          , Rb          , Wwg         , Wwg         , Wwg         , Wwg         , Wwg         , Wwg         , Rb          , Rb          , Gd          , Gd          , Gd          
Gd          , Gd^Eff      , Gd          , Gd^Eff      , Gd          , Gd          , Gd          , Gd          , Gd          , Gd          , Xos         , Xos         , Xos         , Gd          , Gd          , Rb          , Wwg         , Wwg         , Wwg         , Wwg         , Wwg         , Wwg         , Wwg         , Rb^Es       , Rb          , Gd          
Gd          , Gd          , Gd          , Gd          , Gd^Em       , Gd          , Gd          , Gd          , Xos         , Ch          , Rrc         , Rrc         , Rrc         , Ch          , Xos         , Rb          , Rb          , Wwg         , Rb^Em       , Wwg         , Wwg         , Wwg         , Wwg         , Wwg         , Wwg         , Rb          
Gd          , Gd          , Gd          , Gd          , Gd          , Gd          , Gd          , Xos         , Rrc         , Rrc         , Rrc         , Rrc         , Rrc         , Rrc         , Rrc         , Xos         , Gd          , Rb          , Gd          , Rb          , Rb          , Wwg         , Wwg         , Wwg         , Wwg         , Wwg         
Gd          , Gd          , Gd          , Gd          , Gd          , Gd          , Gd          , Xos         , Rrc         , Rrc         , 1 Ch        , Ch          , 2 Ch        , Rrc         , Rrc         , Xos         , Gd          , Gd          , Gd          , Gd          , Gd          , Rb          , Rb          , Wwg         , Wwg         , Wwg         
Gd          , Gd          , Gd          , Gd^Es       , Gd          , Gd          , Gd          , Ch          , Rrc         , Rrc         , 3 Ch        , Rr^Vhc      , 4 Ch        , Rrc         , Rrc         , Ch          , Gd          , Gd          , Gd          , Gd^Es       , Gd          , Gd          , Rb          , Wwg         , Wwg         , Wwg         
Gd          , Gd          , Gd          , Gd          , Gd          , Gd          , Gd          , Xos         , Rrc         , Rrc         , Rrc         , Ch          , Rrc         , Rrc         , Rrc         , Xos         , Gd          , Gd          , Gd          , Gd          , Gd          , Gd          , Gd          , Rb          , Rb          , Rb          
Gd          , Gd          , Gd          , Gd          , Gd          , Gd          , Gd          , Xos         , Xos         , Rrc         , Rrc         , Rrc         , Rrc         , Rrc         , Xos         , Xos         , Gd          , Gd          , Sm          , Gd          , Sm          , Sm          , Gd          , Gd          , Gd          , Gd          
Gd          , Gd          , Gd          , Gd          , Gd          , Gd          , Gd          , Gd          , Gd          , Ch          , Xos         , Rrc         , Xos         , Ch          , Gd          , Gd          , Gd          , Sm          , Sm          , Sm^Es       , Sm          , Sm          , Gd          , Gd          , Gd          , Gd          
Rb          , Gd          , Gd          , Gd          , Gd          , Gd          , Gd          , Gd          , Gd          , Gd          , Gd          , Xos         , Gd          , Gd          , Gd          , Gd          , Gd          , Sm          , Sm          , Sm          , Rb^Emf      , Sm          , Rb          , Gd          , Gd          , Gd          
Wwg         , Rb          , Rb          , Gd          , Gd          , Gd          , Gd          , Gd          , Gd          , Gd          , Gd          , Gd          , Gd          , Gd          , Gd          , Gd          , Sm          , Sm          , Sm          , Rb^Emf      , Rb^Emf      , Rb^Emf      , Wwg         , Rb          , Rb          , Gd          
Wwg         , Wwg         , Rb          , Gd          , Gd          , Gd          , Gd          , Gd^Es       , Gd          , Gd          , Gd          , Gd          , Gd          , Gd          , Gd          , Sm          , Sm          , Sm          , Sm^Em       , Rb^Emf      , Wwg         , Wwg         , Wwg         , Wwg         , Wwg         , Rb          
Wwg         , Wwg         , Wwg         , Rb          , Rb          , Rb          , Rb          , Gd          , Rb          , Gd          , Rb          , Gd          , Rb          , Gd          , Rb^Em       , Sm          , Sm          , Sm^Em       , Wwg         , Wwg         , Wwg         , Wwg         , Wwg         , Wwg         , Wwg         , Wwg         
Wwg         , Wwg         , Wwg         , Wwg         , Wwg         , Wwg         , Wwg         , Rb          , Wwg         , Rb          , Wwg         , Rb          , Wwg         , Rb          , Wwg         , Sm^Em       , Sm^Em       , Sm          , Wwg         , Wwg         , Wwg         , Wwg         , Rb          , Wwg         , Wwg         , Wwg         
Rb          , Wwg         , Wwg         , Wwg         , Wwg         , Wwg         , Wwg         , Wwg         , Wwg         , Wwg         , Wwg         , Wwg         , Wwg         , Wwg         , Wwg         , Wwg         , Wwg         , Wwg         , Wwg         , Wwg         , Rb          , Rb          , Gd          , Rb          , Rb          , Rb          
Gd          , Rb          , Rb          , Wwg         , Wwg         , Wwg         , Wwg         , Wwg         , Wwg         , Wwg         , Wwg         , Wwg         , Wwg         , Wwg         , Wwg         , Wwg         , Wwg         , Wwg         , Wwg         , Wwg         , Rb          , Gd          , Gd          , Gd          , Gd          , Gd          
Gd          , Gd          , Gd          , Rb          , Rb          , Rb          , Rb          , Wwg         , Rb          , Rb          , Rb          , Wwg         , Rb          , Rb          , Rb          , Rb          , Rb          , Wwg         , Rb          , Rb          , Gd          , Gd          , Gd          , Gd          , Gd          , Gd          
Gd          , Gd          , Gd          , Gd          , Gd          , Gd          , Gd          , Rb          , Gd          , Gd          , Gd          , Rb          , Gd          , Gd          , Gd          , Gd          , Gd          , Rb          , Gd          , Gd          , Gd          , Gd          , Gd          , Gd          , Gd          , Gd          
